Preparation of Compounds:<br> Alcohol from alkenes	1 - Acid catalysed hydration<div>2 - Hydroboration oxidation</div><br> Markovnikov for unsymmetrical alkenes; Anti-Markovnikov for hydroboration
Preparation of Compounds:<br> Alcohol from carbonyl compounds	1 - Reduction of aldehydes and ketones<div>2 - Reduction of carboxylic acids and esters</div><br> LiAlH<sub>4</sub>&nbsp;is expensive; Usually acid -&gt; ester -&gt; alcohol
Preparation of Compounds:<br> Alcohol	1 - Alkenes<div>2 - Carbonyl compounds</div><div>3 - Grignard reagents</div><br> 
 Write the reaction for:<br> Acid catalysed hydration of alkenes 	<br> alkene + water (w/ acid) ----&gt; alcohol<br>   
 Mechanism for:<br> Acid catalysed hydration of alkenes 	<br> 1 - Protonation of alkene to form carbocation by electrophilic attack of H<sub>3</sub>O<sup>+</sup><div>2 - Nucleophilic attack of water on carbocation</div><div>3 - Deprotonation to form alcohol</div><br>  
 Write the reaction for:<br> Reduction of aldehydes to alcohols 	<br> R-CHO + H<sub>2</sub>&nbsp;(w/ Pd) ---&gt; RCH<sub>2</sub>OH<br />R-CHO (w/ NaBH<sub>4 </sub>or LiAlH<sub>4</sub>) ---&gt; RCH<sub>2</sub>OH<br> Primary alcohol;  
 Write the reaction for:<br> Reduction of ketones to alcohols 	<br> R-CO-R' + H<sub>2</sub>&nbsp;(w/ Pd/Ni) ---&gt; R-CH(OH)-R'<div>R-CO-R' (w/ NaBH<sub>4 </sub>or LiAlH<sub>4</sub>) ---&gt; R-CH(OH)-R'</div><br>   
 Write the reaction for:<br> Reduction of carboxylic acid to alcohol 	<br> R-COOH (w/&nbsp;LiAlH<sub>4 </sub>+ H<sub>2</sub>O) ---&gt; R-CH<sub>2</sub>OH<br>   
 Write the reaction for:<br> Reduction of esters to alcohols 	<br> RCOOR' (H<sub>2</sub>&nbsp;+ catalyst) ---&gt; RCH<sub>2</sub>OH +R'OH<br>   
 Write the reaction for:<br> Conversion of Grignard reagent to alcohol 	"<span style=""font-family: 'Liberation Sans'"">aldehyde/ketone + RMgX ---&gt; [Adduct] (w/ water) ---&gt; alcohol + Mg(OH)X</span><br> R'CHO + RMgX (w/ H<sub>2</sub>O)&nbsp;---&gt; RR'CH-OH + Mg(OH)X<div>R'(CO)R'' + RMgX (w/ H<sub>2</sub>O)&nbsp;---&gt; RR'R''C-OH + Mg(OH)X</div><br>  <span style=""font-family: 'Liberation Sans'"">Page: 323</span> "
	"<span style=""font-family: 'Liberation Sans'"">aldehyde/ketone + RMgX ---&gt; [Adduct] (w/ water) ---&gt; alcohol + Mg(OH)X</span><br> <br>  <span style=""font-family: 'Liberation Sans'"">Page: 323</span>"
 Write the reaction for:<br> Preparation of phenol from haloarenes 	<br> Ar-X + NaOH (at 623K 300atm) ---&gt; Ar-O<sup>-</sup>Na<sup>+</sup>&nbsp;(w/ HCl) ---&gt; Ar-OH<br>   
 Write the reaction for:<br> Preparation of phenol from benzenesulphonic acid 	<br> Ar-SO<sub>3</sub>H (w/ NaOH + H<sup>+</sup>) ---&gt;Ar-OH<br> benzene (w/ oleum) ---&gt; benzenesulphonic acid ---&gt; phenol  
 Write the reaction for:<br> Preparation of phenol from diazonium salts 	primary amine (w/ nitrous acid) ---&gt; diazonium salt (hydrolysis) ---&gt; phenol<br> Ar-NH<sub>2</sub>&nbsp;(w/ NaNO<sub>2</sub>&nbsp;+ HCl at 273-278K) ---&gt; Ar-N<sub>2</sub><sup>+</sup>Cl<sup>-</sup>&nbsp;(w/ warm H<sub>2</sub>O) ---&gt; Ar-OH + N<sub>2</sub>&nbsp;+ HCl<br>   
	primary amine (w/ nitrous acid) ---&gt; diazonium salt (hydrolysis) ---&gt; phenol<br> <br>  
 Write the reaction for:<br> Hydroboration oxidation of alkenes 	excess alkene + diborane ---&gt; trialkyl borane (w/ H<sub>2</sub>O<sub>2</sub>&nbsp;and NaOH(aq)) ---&gt; alcohol<br> alkene + (H-BH<sub>2</sub>)<sub>2</sub>&nbsp;---&gt; R-BH<sub>2</sub>&nbsp;(w/ alkene) ---&gt; R<sub>2</sub>BH (w/ more alkene) ---&gt; R<sub>3</sub>B (w/ H<sub>2</sub>O<sub>2</sub>&nbsp;+ OH<sup>-</sup>(aq)) ---&gt; 3R-OH + B(OH)<sub>3</sub><br> excellent yield;  
 Write the reaction for:<br> Preparation of phenol from cumene 	<br> isopropylbenzene (w/ O<sub>2</sub>&nbsp;from air) ---&gt; cumenehydroperoxide (w/ dilute acid) ---&gt; phenol + acetone<br> acetone obtained in large quantity;  
Isopropylbenzene is also called <span class=cloze>[...]</span>	Isopropylbenzene is also called <span class=cloze>cumene</span><br> 
<span class=cloze>[...]</span> is also called cumene	<span class=cloze>Isopropylbenzene</span> is also called cumene<br> 
The boiling points of alcohols and phenols increase with increase in the number of carbon atoms because of <span class=cloze>[...]</span>.	The boiling points of alcohols and phenols increase with increase in the number of carbon atoms because of <span class=cloze>increase in van der Waals forces</span>.<br> 
The boiling points of alcohols and phenols <span class=cloze>[...]</span> with increase in the number of carbon atoms because of increase in van der Waals forces.	The boiling points of alcohols and phenols <span class=cloze>increase</span> with increase in the number of carbon atoms because of increase in van der Waals forces.<br> 
In alcohols, the boiling points <span class=cloze>[...]</span> with increase in branching.	In alcohols, the boiling points <span class=cloze>decrease</span> with increase in branching.<br> because van der Waals forces;
In alcohols, the boiling points decrease with <span class=cloze>[...]</span> in branching.	In alcohols, the boiling points decrease with <span class=cloze>increase</span> in branching.<br> because van der Waals forces;
The -OH group in alcohols and phenols is responsible for <span class=cloze>[intermolecualr interaction]</span>.	The -OH group in alcohols and phenols is responsible for <span class=cloze>intermolecular hydrogen bonding</span>.<br> 
The boiling points of alcohols and phenols is <span class=cloze>[...]</span> than corresponding hydrocarbons and ethers because of intermolecular hydrogen bonding	The boiling points of alcohols and phenols is <span class=cloze>higher</span> than corresponding hydrocarbons and ethers because of intermolecular hydrogen bonding<br> 
The boiling points of alcohols and phenols is higher than corresponding hydrocarbons and ethers because of <span class=cloze>[...]</span>	The boiling points of alcohols and phenols is higher than corresponding hydrocarbons and ethers because of <span class=cloze>intermolecular hydrogen bonding</span><br> 
Solubility of alcohols and phenols is due to their ability to <span class=cloze>[...]</span> with water molecules.	Solubility of alcohols and phenols is due to their ability to <span class=cloze>form hydrogen bonds</span> with water molecules.<br> 
Solubility of alcohols and phenols decreases with the <span class=cloze>[...]</span> in size of alkyl/aryl group.	Solubility of alcohols and phenols decreases with the <span class=cloze>increase</span> in size of alkyl/aryl group.<br> 
Solubility of alcohols and phenols <span class=cloze>[...]</span> with the increase in size of alkyl/aryl group.	Solubility of alcohols and phenols <span class=cloze>decreases</span> with the increase in size of alkyl/aryl group.<br> 
 Write the reaction for:<br> Alcohol/Phenol + metals(Na/K/Al) 	"<span style=""font-family: 'Liberation Sans'"">alcohol/phenol + active metal ---&gt; alkoxide/phenoxide + hydrogen gas</span><br> 2R-OH + 2Na ---&gt; 2R-ONa + H<sub>2</sub><br>   "
 Write the reaction for:<br> Phenols + NaOH(aq) 	<br> Ar-OH + NaOH ---&gt; Ar-ONa +H<sub>2</sub>O<br> Bronsted-Lowry acid; donate H<sup>+</sup>&nbsp;to stronger base;  
Alcohols are <span class=cloze>[...]</span> acids than water.	Alcohols are <span class=cloze>weaker</span> acids than water.<br> R-O<sup>-&nbsp;</sup>+ H<sub>2</sub>O ---&gt; R-OH + OH<sup>-</sup>
Phenols are acidic because:	1 - -OH group is attached to an sp<sup>2</sup>&nbsp;hybrid carbon atom; O-H bond is more polar<div>2 - Phenoxide ion is more stable than phenol; because of charge seperation in phenol</div>
 Write the reaction for:<br> Esterification of alcohols 	<br> 1 - Ar/R-OH + R'COOH (w/ H<sup>+</sup>) ---&gt; R'COOR/Ar +H<sub>2</sub>O<div>2 - Ar/R-OH + (R'CO)<sub>2</sub>O (w/ H<sup>+</sup>) ---&gt; R'COOR/Ar +R'COOH<br />3 - Ar/R-OH + R'COCl (w/ pyridine) ---&gt; R'COOR/Ar +HCl</div><br> w/ H<sup>+</sup>&nbsp;from conc. sulphuric acid  
 Name the reaction(s): <br> 1 - Ar/R-OH + R'COOH (w/ H<sup>+</sup>) ---&gt; R'COOR/Ar +H<sub>2</sub>O<div>2 - Ar/R-OH + (R'CO)<sub>2</sub>O (w/ H<sup>+</sup>) ---&gt; R'COOR/Ar +R'COOH<br />3 - Ar/R-OH + R'COCl (w/ pyridine) ---&gt; R'COOR/Ar +HCl</div>	Esterification of alcohols  
o-hydroxybenzoic acid is commonly known as <span class=cloze>[...]</span>.	o-hydroxybenzoic acid is commonly known as <span class=cloze>salicyclic acid</span>.<br> 
<span class=cloze>[...]</span> is commonly known as salicyclic acid.	<span class=cloze>o-hydroxybenzoic acid</span> is commonly known as salicyclic acid.<br> 
Aspirin is produced by <span class=cloze>[...]</span>.	Aspirin is produced by <span class=cloze>acetylation of salicyclic acid</span>.<br> salicyclic acid + acetyl anhydride (w/ H<sup>+</sup>) ---&gt; aspirin + ethanol
<span class=cloze>[...]</span> is produced by acetylation of salicyclic acid.	<span class=cloze>Aspirin</span> is produced by acetylation of salicyclic acid.<br> salicyclic acid + acetyl anhydride (w/ H<sup>+</sup>) ---&gt; aspirin + ethanol
 Write the reaction for:<br> Synthesis of aspirin 	<br> salicyclic acid + acetyl anhydride ---&gt; acetylsalicyclic acid (aspirin) + ethanoic acid<br> Page 330  
Chemical name of <span class=cloze>[...]</span> is acetylsalicyclic acid.	Chemical name of <span class=cloze>aspirin</span> is acetylsalicyclic acid.<br> Page 330
Chemical name of aspirin is <span class=cloze>[...]</span>.	Chemical name of aspirin is <span class=cloze>acetylsalicyclic acid</span>.<br> Page 330
 Write the reaction for:<br> Dehydration of alcohols 	<br> <div>0 - alcohol (w/ H<sup>+</sup>&nbsp;OR anhydrous ZnCl<sub>2</sub>/Al<sub>2</sub>O<sub>3</sub>) ---&gt; alkene + H<sub>2</sub>O<br />1 - C<sub>2</sub>H<sub>5</sub>OH (w/ H<sub>2</sub>SO<sub>4</sub>&nbsp;at 443K) ---&gt; CH<sub>2</sub>=CH<sub>2</sub>&nbsp;+ H<sub>2</sub>O</div><div>2 - propan-2-ol (w/ 85% H<sub>3</sub>PO<sub>4</sub>&nbsp;at 440K) ---&gt; prop-2-ene +water</div><div>3 - 2-methylpropan-2-ol (w/ 20% H<sub>3</sub>PO<sub>4</sub>&nbsp;358K) ---&gt; 2-methylprop-2-ene + water</div><br>   
 Mechanism for:<br> Dehydration of alcohols 	<br> 1 - Formation of protonated alcohol<div>2 - Formation of carbocation (RDS)</div><div>3 - Formation alkene by elimination of proton</div><br>  
 Write the reaction for:<br> Alcohols acting as nucleophiles 	<br> 1 - Cleavage of O-H bond<div>2 - R-O-H + E<sup>+</sup>&nbsp;---&gt; R-O<sup>+</sup>H-E ---&gt; R-O-E + H<sup>+</sup></div><br>   
 Write the reaction for:<br> Alcohols acting as electrophiles 	<br> Cleavage of C-OH bond:<div>1 - R-CH<sub>2</sub>-OH + H<sup>+</sup>&nbsp;---&gt; RCH<sub>2</sub>-O<sup>+</sup>H<sub>2</sub>&nbsp;(protonation)</div><div>2 - RCH<sub>2</sub>-O<sup>+</sup>H<sub>2</sub><sup>&nbsp;</sup>+ Nu<sup>-</sup>&nbsp;---&gt; Nu-CH<sub>2</sub>-R (attack of nucleophile)</div><br>   
State the relative ease of dehydration of alcohols:	Tertiary &gt; Secondary &gt; Primary (involves formation of R<sup>+</sup>)
 Write the reaction for:<br> Oxidation of alcohols 	<br> hydroxy group ---&gt; carbonyl group<br>   
 Write the reaction for:<br> Oxidation of alcohols to carboxylic acids 	<br> RCH<sub>2</sub>OH (w/ acidified KMnO<sub>4</sub>) ---&gt; RCOOH<br>   
 Write the reaction for:<br> Oxidation of alcohols to carbonyl cmpds: 	<br> 1 - RCH<sub>2</sub>OH (w/ CrO<sub>3</sub>) ---&gt; RCHO<div>2 - RCH<sub>2</sub>OH (w/ pyridinium chloro chromate) ---&gt; RCHO (better yield)</div><div>3 - RR'CH-OH (w/ CrO<sub>3</sub>) ---&gt; RR'C=O</div><div>4 - Tertiary alcohols do not undergo oxidation</div><div>5 - RCH<sub>2</sub>OH (w/ Cu at 573K) ---&gt; RCHO</div><div>6 - RR'CH-OH (w/ Cu at 573K) ---&gt; RR'C=O</div><div>7 - RR'R''C-OH (w/ Cu at 573K) ---&gt;alkene</div><br>   
 Write the reaction for:<br> Nitration of phenols 	<br> 1 - phenol (w/ dil HNO<sub>3</sub>&nbsp;at 298K) ---&gt; o/p-nitrophenol<div>2 - phenol (w/ conc HNO<sub>3</sub>) ---&gt; picric acid (poor yield)</div><br> Electrophilic substitution;  
o/p-nitrophenols are seperated by:	steam distillation;<div>o-nitrophenol is steam volatile (intra molecular H bonding)</div><div>p-nitrophenol has higher Bpt. (inter molecular H bonding)</div>
 Write the reaction for:<br> Commercial preparation of picric acid 	<br> phenol (w/ conc H<sub>2</sub>SO<sub>4</sub>) ---&gt; phenol-2,4-disulphonic acid (w/ conc HNO<sub>3</sub>) ---&gt; picric acid<br>   
 Write the reaction for:<br> Halogenation of phenols 	<br> 1 - phenol (w/ Br<sub>2</sub>&nbsp;in CS<sub>2</sub>&nbsp;at 273K) ---&gt; p-bromophenol (major) + o-bromophenol (minor)<div>2 - phenol (w/ Br<sub>2</sub>&nbsp;water) ---&gt;2,4,6-tribromophenol</div><br> Electrophilic substitution  
 Write the reaction for:<br> Kolbe's reaction 	<br> Ar-OH (w/ NaOH) ---&gt; Ar-O<sup>-</sup>Na<sup>+</sup>&nbsp;(w/ CO<sub>2</sub>&nbsp;and H<sup>+</sup>) ---&gt; salicyclic acid<br>   
 Name the reaction(s): <br> Ar-OH (w/ NaOH) ---&gt; Ar-O<sup>-</sup>Na<sup>+</sup>&nbsp;(w/ CO<sub>2</sub>&nbsp;and H<sup>+</sup>) ---&gt; salicyclic acid	Kolbe's reaction  
 Write the reaction for:<br> Reimer-Tiemann reaction 	<br> Ar-OH (w/ CHCl<sub>3</sub>&nbsp;+ aq NaOH) ---&gt; intermediate (w/ NaOH and H<sup>+</sup>) ---&gt; salicycladehyde<br>   
 Name the reaction(s): <br> Ar-OH (w/ CHCl<sub>3</sub>&nbsp;+ aq NaOH) ---&gt; intermediate (w/ NaOH and H<sup>+</sup>) ---&gt; salicycladehyde	Reimer-Tiemann reaction  
 Write the reaction for:<br> Phenol + Zn dust 	<br> Ar-OH + Zn ---&gt; benzene + ZnO<br>   
 Write the reaction for:<br> Oxidation of phenol 	<br> Ar-OH (w/ chromic acid) ---&gt; benzequinone<br> Na<sub>2</sub>Cr<sub>2</sub>O<sub>7</sub>&nbsp;+ H<sub>2</sub>SO<sub>4</sub>&nbsp;gives chromic acid  
 Write the reaction for:<br> Commercial preparation of methanol 	<br> CO + 2H<sub>2</sub>&nbsp;(w/ ZnO-Cr<sub>2</sub>O<sub>3</sub>&nbsp;at 200-300atm 573-673K) ---&gt; CH<sub>3</sub>OH<br>   
Preparation of Compounds:<br> Ethers	1 - Dehydration of alcohols (S<sub>N</sub>2&nbsp;pathway)<div>2 - Williamson synthesis (S<sub>N</sub>2 pathway)</div><br> 
 Write the reaction for:<br> Dehydration of alcohols to give ethers 	<br> <div>0 - R-OH (w/ H<sub>2</sub>SO<sub>4</sub>) ---&gt; R-O-R</div>1 - CH<sub>3</sub>CH<sub>2</sub>OH (w/ H<sub>2</sub>SO<sub>4</sub>&nbsp;at 413K) ---&gt; C<sub>2</sub>H<sub>5</sub>-O-C<sub>2</sub>H<sub>5</sub><br>   
 Mechanism for:<br> Dehydration of alcohols to give ethers 	<br> 1 - Electrophilic attack of H<sup>+</sup>&nbsp;on alcohol<div>2 - Nucleophilic (S<sub>N</sub>2)&nbsp;attack of alcohol on protonated alcohol</div><div>3 - Deprotonation of the intermediate to give ether</div><br>  
 Write the reaction for:<br> Williamson synthesis 	<br> R-X + R'-O<sup>-</sup>Na<sup>+</sup>&nbsp;---&gt; R-O-R' + NaX<br>   
 Name the reaction(s): <br> R-X + R'-O<sup>-</sup>Na<sup>+</sup>&nbsp;---&gt; R-O-R' + NaX	Williamson synthesis  
 Mechanism for:<br> Williamson synthesis 	<br> 1 - Nucleophilic (S<sub>N</sub>2) attack of alkoxide on alkyl halide<div>2 - Liberation of X<sup>-</sup></div><br>  
 Write the reaction for:<br> Conversion of phenol to ether 	<br> phenol (w/ NaOH) ---&gt; phenoxide<div>phenoxide + RX ---&gt; Ar-OR (Williamson synthesis)</div><br>   
The Bpt of ethers is similar to those of <span class=cloze>[...]</span> of similar molecular masses but much less than those of corresponding <span class=cloze>[...]</span> because of weak polarity of ether molecule.	The Bpt of ethers is similar to those of <span class=cloze>alkanes</span> of similar molecular masses but much less than those of corresponding <span class=cloze>alcohols</span> because of weak polarity of ether molecule.<br> 
The Bpt of ethers is similar to those of alkanes of similar molecular masses but much less than those of corresponding alcohols because of <span class=cloze>[...]</span>.	The Bpt of ethers is similar to those of alkanes of similar molecular masses but much less than those of corresponding alcohols because of <span class=cloze>weak polarity of ether molecule</span>.<br> 
Ethers are soluble in water because <span class=cloze>[...]</span>.	Ethers are soluble in water because <span class=cloze>they form hydrogen bonds with water molecules</span>.<br> 
 Write the reaction for:<br> Ethers with halogen acids (primary/secondary groups on ether) 	<br> 1 - R-O-R' + HX ---&gt; RX + R'-OH (R contains the least substituted carbon)<div>2 - Ar-OR + HX ---&gt; RX +Ar-OH (Ar-O bond is stronger)</div><br>   
 Mechanism for:<br> Ethers with halogen acids (primary/secondary groups on ether) 	<br> 1 - Protonation of ether by H<sup>+</sup>&nbsp;from HX<div>2 - Attack of X<sup>-</sup>&nbsp;on the least substituted carbon of the C-O bond (S<sub>N</sub>2 attack)</div><div>3 - (if HX is in excess) protonation of alcohol by H<sup>+ </sup>from HX; attack of X<sup>-</sup>&nbsp;on protonated alcohol; dehydration to give alkyl halide</div><br>  
 Write the reaction for:<br> R'-O-R + HI; if R' is a tertiary group 	<br> R'-O-R +HI ---&gt; R-OH + R'I<br>   
 Mechanism for:<br> R'-O-R + HI; if R' is a tertiary group 	<br> 1 - Protonation of ether by H<sup>+</sup>&nbsp;from HI<div>2 - Formation of carbocation (RDS); R'-O<sup>+</sup>H-R ---&gt; R'<sup>+</sup>&nbsp;+ R-OH</div><div>3 - Attack of nucleophile on carbocation; R'<sup>+</sup>&nbsp;+ I<sup>-</sup>&nbsp;---&gt; R'I</div><br>  
 Write the reaction for:<br> Halogenation of phenyl ethers 	<br> Ar-OCH<sub>3</sub><sup>&nbsp;</sup>(w/ Br<sub>2</sub>&nbsp;in ethanoic acid) ---&gt; p-bromoanisole (major)<br>   
 Write the reaction for:<br> Friedel-Crafts reaction for Ether 	<br> Ar-OR + CH<sub>3</sub>Cl (w/ anhyd AlCl<sub>3 </sub>and CS<sub>2</sub>) ---&gt; p-alkoxy-toluene<div>Ar-OR + CH<sub>3</sub>COCl (w/ anhyl AlCl<sub>3</sub>) ---&gt; p-alkoxy-toluene</div><br> ortho isomers are also generated as minor pdts;  
 Write the reaction for:<br> Nitration of anisole 	<br> Ar-OCH<sub>3</sub> (w/ H<sub>2</sub>SO<sub>4</sub>&nbsp;+ HNO<sub>3</sub>) ---&gt; p-nitroanisole(major) + o-nitroanisole(minor)<br>   
<span class=cloze>[...]</span> is used to distinguish the three classes of alcohols.	<span class=cloze>Lucas test</span> is used to distinguish the three classes of alcohols.<br> 3<sup>o</sup>&nbsp;give turbidity instantly; 1<sup>o</sup>&nbsp;do not give turbidity at toom temperature.
 Write the reaction for:<br> Lucas test 	<br> R-OH (soluble) + HX ---&gt; R-X (insoluble) + H<sub>2</sub>O<br> Insoluble R-X is responsible for turbidity; 3<sup>o</sup>&nbsp;alcohols are most reactive  
Preparation of Compounds:<br> Aldehydes	0 - Oxidation of alcohols/dehydrogenation of alcohols<div>0 - Ozonolysis of alkenes/hydration of alkynes</div><div>1 - From acyl chlorides</div><div>2 - From nitriles and esters</div><div>3 - From hydrocarbons</div><br> 
Preparation of Compounds:<br> Aldehydes from hydrocarbons	1 - Oxidation of methylbenzene<div>&nbsp; &nbsp;a - Use of chromyl chloride (Etard rxn)</div><div>&nbsp; &nbsp;b - Use of chromic oxide</div><div>2 - Side chain chlorination followed by oxidation</div><div>3 - Gatterman-Koch reaction</div><br> 
 Write the reaction for:<br> Rosenmund reduction 	<br> Ar-COCl (w/ H<sub>2</sub>&nbsp;over Pd-BaSO<sub>4</sub>) ---&gt; Ar-CHO<br> Prep aldehyde from acid chloride  
 Name the reaction(s): <br> Ar-COCl (w/ H<sub>2</sub>&nbsp;over Pd-BaSO<sub>4</sub>) ---&gt; Ar-CHO	Rosenmund reduction  
 Write the reaction for:<br> Stephen reaction 	nitrile + SnCl<sub>2</sub>&nbsp;+ HCl ---&gt; imine (hydrolysis) ---&gt; aldehyde<br> R-CN + SnCl<sub>2</sub>&nbsp;+HCl ---&gt; RCH=NH (w/ H<sub>3</sub>O<sup>+</sup>) ---&gt; RCHO<br>   
 Name the reaction(s): <br> R-CN + SnCl<sub>2</sub>&nbsp;+HCl ---&gt; RCH=NH (w/ H<sub>3</sub>O<sup>+</sup>) ---&gt; RCHO	Stephen reaction  
 Write the reaction for:<br> Selective reduction of nitriles to aldehydes 	<br> R-CN (w/ AlH(i-Bu)<sub>2 </sub>and H<sub>2</sub>O) ---&gt; RCHO<br>   
 Write the reaction for:<br> Selective reduction of esters to aldehydes 	<br> RCOOR' (w/ AlH(i-Bu)<sub>2</sub>&nbsp;and H<sub>2</sub>O) ---&gt;RCHO<br>   
 Write the reaction for:<br> Etard reaction 	methylbenzene (w/ chromyl chloride) ---&gt; chromium complex (w/ hydrolysis) ---&gt; aldehyde<br> Ar-CH<sub>3</sub>&nbsp;+ CrO<sub>2</sub>Cl<sub>2</sub>&nbsp;(w/ CS<sub>2</sub>) ---&gt; Ar-CH(OCrOHCl<sub>2</sub>)<sub>2</sub>&nbsp;(w/ H<sub>3</sub>O<sup>+</sup>) ---&gt; R-CHO<br>   
 Name the reaction(s): <br> Ar-CH<sub>3</sub>&nbsp;+ CrO<sub>2</sub>Cl<sub>2</sub>&nbsp;(w/ CS<sub>2</sub>) ---&gt; Ar-CH(OCrOHCl<sub>2</sub>)<sub>2</sub>&nbsp;(w/ H<sub>3</sub>O<sup>+</sup>) ---&gt; R-CHO	Etard reaction  
 Write the reaction for:<br> Oxidation of methylbenzene to an aldehyde using chromic oxide 	<br> Ar-CH<sub>3</sub>&nbsp;+ CrO<sub>3</sub>&nbsp;+ (CH<sub>3</sub>CO)<sub>2</sub>O (at 273-283K) ---&gt; Ar-CH(OCOCH<sub>3</sub>)<sub>2</sub>&nbsp;(w/ H<sub>3</sub>O<sup>+&nbsp;</sup>and heat) ---&gt; Ar-CHO<br>   
 Write the reaction for:<br> Side chain chlorination to give aldehyde 	Toluene (side chain chlorination) ---&gt; benzal chloride (hydrolysis) ---&gt;benzaldehyde<br> Ar-CH<sub>3</sub>&nbsp;(w/ Cl<sub>2</sub>&nbsp;and hf) ---&gt; Ar-CHCl<sub>2</sub>&nbsp;(w/ H<sub>2</sub>O at 373K) ---&gt; Ar-CHO<br>   
 Write the reaction for:<br> Gatterman-Koch reaction 	<br> benzene (w/ CO, HCl and anhyd. CuCl/AlCl<sub>3</sub>) ---&gt; Ar-CHO<br>   
 Name the reaction(s): <br> benzene (w/ CO, HCl and anhyd. CuCl/AlCl<sub>3</sub>) ---&gt; Ar-CHO	Gatterman-Koch reaction  
Preparation of Compounds:<br> Ketones	0 - Oxidation/dehydrogenation of alcohols<div>0 - Ozonolysis of alkenes/ hydration of alkynes</div><div>1 - From acyl chlorides</div><div>2 - From nitriles</div><div>3 - From benzene or substituted benzenes (Friedel-Crafts acylation)</div><br> 
 Write the reaction for:<br> Conversion of acyl chloride to ketone 	<br> 2R'-COCl + R<sub>2</sub>Cd ---&gt; 2R'RC=O + CdCl<sub>2</sub><br>   
 Write the reaction for:<br> Conversion of nitriles to ketones 	nitrile (w/ Grignard reagent) ---&gt; intermediate (hydrolysis) ---&gt; ketone<br> R'-CN + RMgX (in ether) ---&gt; R'RC=NMgBr (w/ H<sub>3</sub>O<sup>+</sup>) ---&gt; R'RC=O<br>   
 Write the reaction for:<br> Friedel-Crafts acylation of benzene to give ketone 	<br> benzene + RCOCl (w/ anhyd. AlCl<sub>3</sub>) ---&gt; (R)(Ar)C=O<br>   
Preparation of Compounds:<br> dialkylcadmium	2RMgX + CdCl<sub>2</sub>&nbsp;---&gt; R<sub>2</sub>Cd + 2Mg(X)Cl<br> 
<span class=cloze>[aldehyde]</span> is a gas at room temperature. <span class=cloze>[aldehyde]</span> is a volatile liquid. <span class=cloze>[...]</span> are solids at room temperature.	<span class=cloze>Methanal</span> is a gas at room temperature. <span class=cloze>Ethanal</span> is a volatile liquid. <span class=cloze>Higher aldehydes and ketones</span> are solids at room temperature.<br> 
Methanal is a <span class=cloze>[...]</span> at room temperature. Ethanal is a <span class=cloze>[...]</span>. Higher aldehydes and ketones are <span class=cloze>[...]</span> at room temperature.	Methanal is a <span class=cloze>gas</span> at room temperature. Ethanal is a <span class=cloze>volatile liquid</span>. Higher aldehydes and ketones are <span class=cloze>solids</span> at room temperature.<br> 
The boiling points of <span class=cloze>[...]</span> are <span class=cloze>[...]</span> than hydrocarbons and ethers of comparable molecular masses due to weak dipole-diploe interactions. Their boiling points are <span class=cloze>[...]</span> than alcohols of similar molecular masses because of no hydrogen bonding.	The boiling points of <span class=cloze>aldehydes and ketones</span> are <span class=cloze>higher</span> than hydrocarbons and ethers of comparable molecular masses due to weak dipole-diploe interactions. Their boiling points are <span class=cloze>lower</span> than alcohols of similar molecular masses because of no hydrogen bonding.<br> 
The boiling points of aldehydes and ketones are higher than hydrocarbons and ethers of comparable molecular masses due to <span class=cloze>[...]</span>. Their boiling points are lower than alcohols of similar molecular masses because of <span class=cloze>[...]</span>.	The boiling points of aldehydes and ketones are higher than hydrocarbons and ethers of comparable molecular masses due to <span class=cloze>weak dipole-diploe interactions</span>. Their boiling points are lower than alcohols of similar molecular masses because of <span class=cloze>no hydrogen bonding</span>.<br> 
<span class=cloze>[carbonyl compounds]</span> are miscilbe in water because they form hydrogen bonds with water molecules.	<span class=cloze>Lower aldehydes and ketones (methanal, ethanal, propanone)</span> are miscilbe in water because they form hydrogen bonds with water molecules.<br> 
Lower aldehydes and ketones (methanal, ethanal, propanone) are <span class=cloze>[...]</span> in water because they <span class=cloze>[...]</span>	Lower aldehydes and ketones (methanal, ethanal, propanone) are <span class=cloze>miscilbe</span> in water because they <span class=cloze>form hydrogen bonds with water molecules.</span><br> 
Solubility of <span class=cloze>[...]</span> decreases rapidly with increase in length of alkyl chain. They are soluble in organic solvents.	Solubility of <span class=cloze>aldehydes and ketones</span> decreases rapidly with increase in length of alkyl chain. They are soluble in organic solvents.<br> 
Solubility of aldehydes and ketones <span class=cloze>[...]</span> rapidly with increase in length of alkyl chain. They are soluble in organic solvents.	Solubility of aldehydes and ketones <span class=cloze>decreases</span> rapidly with increase in length of alkyl chain. They are soluble in organic solvents.<br> 
Lower aldehydes and ketones have <span class=cloze>[...]</span> odours. As the size of the molecule increases the odour <span class=cloze>[...]</span>.	Lower aldehydes and ketones have <span class=cloze>sharp pungent</span> odours. As the size of the molecule increases the odour <span class=cloze>becomes less pungent and more fragrant</span>.<br> 
 Mechanism for:<br> Nucleophlic addition in aldehydes and ketones 	<br> 1 - Attack of nucleophile on electrophilic carbon to give tetrahedral alkoxide intermediate (change in hybridisation of C from sp<sup>2</sup>&nbsp;to sp<sup>3</sup>)<div>2 - Proton capture by intermediate to give electrically neutral pdt.</div><br>  
Aldehydes are <span class=cloze>[...]</span> reactive than ketones in nucleophilic addition reactions due to <span class=cloze>[...]</span>.	Aldehydes are <span class=cloze>more</span> reactive than ketones in nucleophilic addition reactions due to <span class=cloze>stearic and electronic reasons</span>.<br> Stearic: large substituents on ketone hiders approach of nucleophile<div>Electronic: two alkyl groups on ketone reduces electrophilicity of carbonyl</div>
1 - Stearically aldehydes are more reactive than ketones because: <span class=cloze>[...]</span>.<div>2 - Electronically aldehydes are more reactive than ketones because: <span class=cloze>[...]</span>.</div>	1 - Stearically aldehydes are more reactive than ketones because: <span class=cloze>presence of relatively large substituents in ketone hinders approach of nucleophile to carbonyl carbon</span>.<div>2 - Electronically aldehydes are more reactive than ketones because: <span class=cloze>two alkyl groups in ketone reduce the electrophilicity of carbonyl more effectively</span>.</div><br> 
	<br> 
 Write the reaction for:<br> Addition of HCN to carbonyl compounds 	HCN (w/ base) ---&gt; CN<sup>-</sup>&nbsp;(w/ abC=O) ---&gt; abC(CN)(O<sup>-</sup>) (w/ H<sup>+</sup>&nbsp;capture) ---&gt; cyanohydrin<br> HCN + abC=O (w/ OH<sup>-</sup>)&nbsp;---&gt; abC(CN)(OH)<br> Rxn w/ pure HCN is very slow  
 Mechanism for:<br> Addition of HCN to carbonyl compounds 	HCN (w/ base) ---&gt; CN<sup>-</sup>&nbsp;(w/ abC=O) ---&gt; abC(CN)(O<sup>-</sup>) (w/ H<sup>+</sup>&nbsp;capture) ---&gt; cyanohydrin<br> 1 - Attack of OH<sup>-</sup>&nbsp;on HCN to yeild nucleophile CN<sup>-</sup><div>2 - Nucleophilic attack on CN<sup>-</sup>&nbsp;on electrophilic carbonyl carbon</div><div>3 - Proton capture by intermediate to yeild cyanohydrin</div><br> Rxn w/ pure HCN is very slow 
 Write the reaction for:<br> Addition of sodium hydrogensulphite&nbsp;to carbonyl compounds 	<br> abC=O + NaHSO<sub>3</sub>&nbsp;---&gt; abC(SO<sub>3</sub>H)(ONa) (w/ proton transfer) ---&gt; abC(SO<sub>3</sub>Na)(OH)<br> Pdt: water soluble; rxn reversed by adding dilute acid/alkali;  
<span class=cloze>[reagent]</span> can be used for seperation and purification of aldehydes.	<span class=cloze>Sodium hydrogensulphite</span> can be used for seperation and purification of aldehydes.<br> 1 - aldehyde + NaHSO<sub>3</sub>&nbsp;---&gt; RCH(SO<sub>3</sub>Na)(OH)<div>2 - RCH(SO<sub>3</sub>Na)(OH) (w/ mineral acid/alkali) ---&gt; aldehyde</div>
 Write the reaction for:<br> Addition of alcohols to carbonyl compounds 	<br> 1 - RCHO (w/ R'OH and HCl gas) ---&gt; RCH(OR')(OH) (w/ R'OH and H<sup>+</sup>) ---&gt; RCH(OR')<sub>2</sub>&nbsp;+ H<sub>2</sub>O<div>2 - ketone + ethylene glycol (w/ HCl gas) ---&gt; ethylene glycol ketal + H<sub>2</sub>O</div><br>  pg 359 
 Mechanism for:<br> Addition of alcohols to carbonyl compounds 	<br> 1 - Protonation of carbonyl oxygen from dry HCl to yield (R)(H)(OH)C<sup>+</sup>&nbsp;carbocation<div>2 - Attack of carbocation on alcohol to yield hemiacetal</div><div>3 - Reaction with excess alcohol to yield acetal</div><br>  pg 359
 Write the reaction for:<br> Addition of ammonia/derivatives to carbonyl compounds 	<br> abC=O + H<sub>2</sub>N-Z (w/ acid) &lt;---&gt; [abC(OH)(NHZ)] ---&gt; abC=NZ + H<sub>2</sub>O<div>Z = alkyl, aryl, OH, NH<sub>2</sub>, C<sub>6</sub>H<sub>5</sub>NH, NHCONH<sub>2</sub>, etc.</div><br>   
 Write the reaction for:<br> Clemmensen reduction 	<br> abC=O (w/ Zn-Hg and HCl) ---&gt; abCH<sub>2&nbsp;</sub>+ H<sub>2</sub>O<br>   
 Name the reaction(s): <br> abC=O (w/ Zn-Hg and HCl) ---&gt; abCH<sub>2&nbsp;</sub>+ H<sub>2</sub>O	Clemmensen reduction  
 Write the reaction for:<br> Wolff-Kishner reduction 	<br> abC=O (w/ hydrazine) ---&gt; abC=N-NH<sub>2</sub>&nbsp;(w/ KOH with ethylene glycol and heat) ---&gt; abCH<sub>2</sub>&nbsp;+ N<sub>2</sub><br>   
 Name the reaction(s): <br> abC=O (w/ hydrazine) ---&gt; abC=N-NH<sub>2</sub>&nbsp;(w/ KOH with ethylene glycol and heat) ---&gt; abCH<sub>2</sub>&nbsp;+ N<sub>2</sub>	Wolff-Kishner reduction  
 Write the reaction for:<br> Oxidation of carbonyl compounds 	<br> R-CHO (w/ HNO<sub>3</sub>/KMnO<sub>4</sub>/K<sub>2</sub>Cr<sub>2</sub>O<sub>7</sub>/Tollen's reagent/Fehling's reagent) ---&gt; RCOOH<div>(R-CH<sub>2</sub>)<sub>2</sub>-C=O (w/ [O]) ---&gt; R-CH<sub>2</sub>COOH + RCOOH</div><br>   
 Write the reaction for:<br> Tollen's test 	<br> R-CHO + 2[Ag(NH<sub>3</sub>)<sub>2</sub>]<sup>+</sup>&nbsp;+ 3OH<sup>-</sup>&nbsp;---&gt; RCOO<sup>-</sup>&nbsp;+ 2Ag + 2H<sub>2</sub>O + 4NH<sub>3</sub><br> Aldehydes are oxidised to carboxylate anion; Rxn occurs in alkaline medium; Silver mirror formed confirms aldehydes;  
 Write the reaction for:<br> Fehling's test 	<br> R-CHO + 2Cu<sup>2+</sup>&nbsp;+ 5OH<sup>-&nbsp;</sup>---&gt; RCOO<sup>-</sup>&nbsp;+ Cu<sub>2</sub>O<sub>2</sub>&nbsp;+ 3H<sub>2</sub>O<br> Aromatic aldehydes show no rxn;  
 Write the reaction for:<br> Oxidation of methyl ketones by haloform reaction 	methyl ketone (w/ NaOX) ---&gt; sodium alkaloate + haloform<br> (R)(CH<sub>3</sub>)C=O (w/ NaOX) ---&gt; (R)(ONa)C=O + CHX<sub>3</sub><br> Rxn not affected by C=C double bond;  
1 - +I effect causes shift of electrons <span class=cloze>[...]</span><div><br /><div>2 - -I effect causes shift of electrons <span class=cloze>[...]</span></div></div>	1 - +I effect causes shift of electrons <span class=cloze>towards the alpha carbon C-&lt;-X</span><div><br /><div>2 - -I effect causes shift of electrons <span class=cloze>away from the alpha carbon C-&gt;-Y</span></div></div><br> 
1 - Acidic nature increases due to <span class=cloze>[inductive effect]</span><div><br /></div><div>2 - Basic nature increases due to <span class=cloze>[inductive effect]</span></div>	1 - Acidic nature increases due to <span class=cloze>-I effect as electron density decreases</span><div><br /></div><div>2 - Basic nature increases due to <span class=cloze>+I effect as electron density increases</span></div><br> 
Order of -I effect	N<sup>+</sup>H<sub>3</sub>&nbsp;&gt; NO<sub>2</sub>&nbsp;&gt; F &gt; COOH &gt; Cl &gt; Br &gt; OH &gt; C<sub>6</sub>H<sub>5</sub>
A system with alternating sigma and pi bonds is called a <span class=cloze>[...]</span>.	A system with alternating sigma and pi bonds is called a <span class=cloze>conjugate system</span>.<br> Lone pair of e<sup>-</sup>&nbsp;acts as a pi bond
A system with <span class=cloze>[...]</span> is called a conjugate system.	A system with <span class=cloze>alternating sigma and pi bonds</span> is called a conjugate system.<br> Lone pair of e<sup>-</sup>&nbsp;acts as a pi bond
1 - <span class=cloze>[Mesomeric effect]</span> causes displacement of electrons towards the alpha carbon<div><br /></div><div>2 - <span class=cloze>[Mesomeric effect]</span> causes displacement of electrons away from the alpha carbon</div>	1 - <span class=cloze>+M effect</span> causes displacement of electrons towards the alpha carbon<div><br /></div><div>2 - <span class=cloze>-M effect</span> causes displacement of electrons away from the alpha carbon</div><br> 
1 - +M effect causes displacement of electrons <span class=cloze>[...]</span><div><br /></div><div>2 - -M effect causes displacement of electrons <span class=cloze>[...]</span></div>	1 - +M effect causes displacement of electrons <span class=cloze>towards the alpha carbon</span><div><br /></div><div>2 - -M effect causes displacement of electrons <span class=cloze>away from the alpha carbon</span></div><br> 
1 - <span class=cloze>[Inductive effect]</span> causes shift of electrons towards the alpha carbon C-&lt;-X<div><br /><div>2 - <span class=cloze>[Inductive effect]</span> causes shift of electrons away from the alpha carbon C-&gt;-Y</div></div>	1 - <span class=cloze>+I effect</span> causes shift of electrons towards the alpha carbon C-&lt;-X<div><br /><div>2 - <span class=cloze>-I effect</span> causes shift of electrons away from the alpha carbon C-&gt;-Y</div></div><br> 
	<br> 
Define electromeric effect	In presence of an electrophile, there is a complete transfer of pi electrons from one atom to the other to produce temporary polarity on atoms joined by multiple bonds.<div><br /></div><div>&gt;C=C&lt; (w/ electrophile) ---&gt; &gt;C<sup>+</sup>--C<sup>-</sup>&lt;</div>
Give an example of hyper conjugation overpowering inductive effect	Nitration of p-isopropyl toluene and p-tertbutyl toluene.
Order of stability of free radicals:	allyl, benzyl &gt; tertiary &gt; secondary &gt; primary (resonance, hyperconjugation)
Order of stability of carbonium ions	tertiary &gt; secondary &gt; primary (hyperconjugation)
Structure of carbocation:	1 - +ve carbon bonded to 3 other atoms; no non bonding electrons<div>2 - +ve carbon is sp<sup>2</sup>&nbsp;hybridized</div><div>3 - planar structure; 120<sup>o</sup>&nbsp;bond angle</div><div>4 - vacant unhybridized p orbital perpendicular to plane of molecule</div>
Explain the reason for extra stability of allylic/benzylic carbocation	Positive charge is delocalised due to resonance
Explain effect of substitutents on stability of benzylic carbocation:	1 - Electron releasing p-methoxy and p-amino groups stablise the carbocation<div>2 - Electron withdrawing groups like p-nitro destablise the carbocation</div>
Structure of carbanion:	1 - -ve carbon is sp<sup>3</sup>&nbsp;hybridized<div>2 - Electron pair occupies one apex of the tetrahedron</div><div>3 - The electron pair rapidly oscillates from one side of the plane to the other</div>
Explain the structure of free radicals:	1 - Contains one or more unpaired electrons; paramagnetic<div>2 - Detected by electron spin resonance</div><div>3 - Simple alkyl radicals have planar trigonal geometry: sp<sup>2</sup>&nbsp;hybrid central atom; unpaired e<sup>-</sup>&nbsp;in unhybridized p orbital</div><div>4 - Pyramidal geometry also possible; unpaired e<sup>-</sup>&nbsp;in sp<sup>3</sup>&nbsp;orbital</div>
Allyl and benzyl free radicals are extra stable due to <span class=cloze>[...]</span>.	Allyl and benzyl free radicals are extra stable due to <span class=cloze>resonance</span>.<br> 
Define Carbenes.	1 - Neutral intermediatees<div>2 - Bivalent carbon atom</div><div>3 - Carbon covalently bonded to two other groups</div><div>4 - Two valence electron distributed in two non bonding orbitals</div><div>5 - Singlet carbene: paired spin of valence e<sup>-</sup></div><div>6 - Triplet carbene: parallel spin of valence e<sup>-</sup></div>
Describe the structure of carbenes.	1 - Singlet carbene:<div>&nbsp; &nbsp; a - bent sp<sup>2</sup>&nbsp;hybrid shape</div><div>&nbsp; &nbsp; b - paired e<sup>-</sup>&nbsp;occupy the vacant sp<sup>2</sup>&nbsp;orbital</div><div>2 - Triplet carbene:</div><div>&nbsp; &nbsp; a - bent sp<sup>2 </sup>hybrid&nbsp;shape: valence e<sup>-</sup>&nbsp;occupy sp<sup>2</sup>&nbsp;and p orbitals</div><div>&nbsp; &nbsp; b - linear sp hybrid shape: valence e<sup>-</sup>&nbsp;occupy unhybridized p orbitals</div>
Describe the generation of carbenes.	1 - Thermal/photochemical decomposition of diazoalkanes<div>2 - alpha elimination of hydrogen halide from a haloform with base</div><div>3 - alpha elimination of halogen from a gem dihalide with a metal</div>
Valence electrons in <span class=cloze>[...]</span> carbenes have paired spin.	Valence electrons in <span class=cloze>singlet</span> carbenes have paired spin.<br> valence e<sup>- </sup>occupy vacant sp<sup>2</sup>&nbsp;orbital
Valence electrons in singlet carbenes have <span class=cloze>[...]</span> spin.	Valence electrons in singlet carbenes have <span class=cloze>paired</span> spin.<br> valence e<sup>- </sup>occupy vacant sp<sup>2</sup>&nbsp;orbital
Valence electrons in <span class=cloze>[...]</span> carbenes have parallel spin.	Valence electrons in <span class=cloze>triplet</span> carbenes have parallel spin.<br> 
Valence electrons in triplet carbenes have <span class=cloze>[...]</span> spin.	Valence electrons in triplet carbenes have <span class=cloze>parallel</span> spin.<br> 
<span class=cloze>[carbenes]</span> attached to bivalent carbon exist as singlets.	<span class=cloze>Dihalogenocarbenes and carbenes with oxygen, nitrogen, sulphur atoms</span> attached to bivalent carbon exist as singlets.<br> 
Dihalogenocarbenes and carbenes with oxygen, nitrogen, sulphur atoms attached to bivalent carbon exist as <span class=cloze>[singlet/triplet]</span>.	Dihalogenocarbenes and carbenes with oxygen, nitrogen, sulphur atoms attached to bivalent carbon exist as <span class=cloze>singlets</span>.<br> 
<span class=cloze>[...]</span> to an olefinic double bond gives cyclopropane derivatives.	<span class=cloze>Addition of carbenes</span> to an olefinic double bond gives cyclopropane derivatives.<br> addition of singlet is much more stereoselective than triplet carbenes
Addition of carbenes to an olefinic double bond gives <span class=cloze>[...]</span> derivatives.	Addition of carbenes to an olefinic double bond gives <span class=cloze>cyclopropane</span> derivatives.<br> addition of singlet is much more stereoselective than triplet carbenes
Addition of carbenes to an <span class=cloze>[...]</span> gives cyclopropane derivatives.	Addition of carbenes to an <span class=cloze>olefinic double bond</span> gives cyclopropane derivatives.<br> addition of singlet is much more stereoselective than triplet carbenes
 Write the reaction for:<br> Acidity of alpha hydrogen of aldehydes and ketones 	<br> OC-C-H + :B ---&gt; [O=C-C<sup>-</sup>&nbsp;&lt;--&gt; <sup>-</sup>O-C=C] + BH<br>   
 Write the reaction for:<br> Aldol reaction 	aldehyde/ketone (w/ dil. alkali) ---&gt; betahydroxy aldehyde/ketone<br> 1 - 2CH<sub>3</sub>CHO (w/ dil NaOH) ---&gt; CH<sub>3</sub>-C(OH)H-CH<sub>2</sub>-CHO<div>2 - 2CH<sub>3</sub>-CO-CH<sub>3&nbsp;</sub>(w/ Ba(OH)<sub>2</sub>) ---&gt; (CH<sub>3</sub>)<sub>2</sub>(OH)C-CH<sub>2</sub>-CO-CH3</div><br>   
 Name the reaction(s): <br> 1 - 2CH<sub>3</sub>CHO (w/ dil NaOH) ---&gt; CH<sub>3</sub>-C(OH)H-CH<sub>2</sub>-CHO<div>2 - 2CH<sub>3</sub>-CO-CH<sub>3&nbsp;</sub>(w/ Ba(OH)<sub>2</sub>) ---&gt; (CH<sub>3</sub>)<sub>2</sub>(OH)C-CH<sub>2</sub>-CO-CH3</div>	Aldol reaction  
 Write the reaction for:<br> Aldol condensation 	1 - aldehyde (w/ alkali) ---&gt; betahydroxy aldehyde (-H<sub>2</sub>O) ---&gt; alphabetaunsaturated aldehyde<div><br /></div><div>2 - ketone (w/ alkali) ---&gt; betahydroxy ketone (-H<sub>2</sub>O) ---&gt; alphabetaunsaturated ketone</div><br> 1 - 2CH<sub>3</sub>CHO (w/ dil. NaOH) ---&gt; CH<sub>3</sub>-CH(OH)-CH<sub>2</sub>-CHO (w/ heat, -H<sub>2</sub>O) ---&gt; CH<sub>3</sub>-CH=CH-CHO<div><div>2 - 2CH<sub>3</sub>COCH<sub>3</sub>&nbsp;(w/ Ba(OH)<sub>2</sub>) (CH<sub>3</sub>)<sub>2</sub>(OH)C-CH<sub>2</sub>CO-CH<sub>3</sub>&nbsp;(w/ heat, -H<sub>2</sub>O) ---&gt; (CH<sub>3</sub>)<sub>2</sub>C=CH-CO-CH<sub>3</sub></div></div><br>   
 Name the reaction(s): <br> 1 - 2CH<sub>3</sub>CHO (w/ dil. NaOH) ---&gt; CH<sub>3</sub>-CH(OH)-CH<sub>2</sub>-CHO (w/ heat, -H<sub>2</sub>O) ---&gt; CH<sub>3</sub>-CH=CH-CHO<div><div>2 - 2CH<sub>3</sub>COCH<sub>3</sub>&nbsp;(w/ Ba(OH)<sub>2</sub>) (CH<sub>3</sub>)<sub>2</sub>(OH)C-CH<sub>2</sub>CO-CH<sub>3</sub>&nbsp;(w/ heat, -H<sub>2</sub>O) ---&gt; (CH<sub>3</sub>)<sub>2</sub>C=CH-CO-CH<sub>3</sub></div></div>	Aldol condensation  
 Write the reaction for:<br> Cannizzaro reaction 	2aldehyde + alkali ---&gt; alcohol + carboxylic acid salt<br> 1 - 2H<sub>2</sub>C=O + conc KOH (w/ heat) ---&gt; CH<sub>3</sub>OH + HCOOK<div>2 - 2Ar-CHO +conc NaOH (w/ heat) ---&gt; Ar-CH<sub>2</sub>OH + Ar- COONa</div><br>   
 Name the reaction(s): <br> 1 - 2H<sub>2</sub>C=O + conc KOH (w/ heat) ---&gt; CH<sub>3</sub>OH + HCOOK<div>2 - 2Ar-CHO +conc NaOH (w/ heat) ---&gt; Ar-CH<sub>2</sub>OH + Ar- COONa</div>	Cannizzaro reaction  
 Write the reaction for:<br> Nitration of aryl aldehydes 	<br> Ar-CHO (w/ HNO<sub>3</sub>/H<sub>2</sub>SO<sub>4</sub>&nbsp;at 273-283K) ---&gt; m-Ar(CHO)(NO<sub>2</sub>)<br>   
 Write the reaction for:<br> Cross aldol condensation 	<br> CH<sub>3</sub>CHO + CH<sub>3</sub>CH<sub>2</sub>CHO (w/ NaOH + heat) ---&gt; CH<sub>3</sub>-CH=CH-CHO + CH<sub>3</sub>CH<sub>2</sub>CH=CH(CH3)(CHO) + CH<sub>3</sub>CH=C(CH<sub>3</sub>)CHO + CH<sub>3</sub>CH<sub>2</sub>CH=CHCHO<br>   
Preparation of Compounds:<br> Carboxylic acid	1 - Oxidation of primary alcohols and aldehydes<div>2 - Vigorous oxidation alkyl benzenes</div><div>3 - nitrile (w/ H<sup>+</sup>/OH<sup>-</sup>&nbsp;+ H<sub>2</sub>O) ---&gt; amide (w/ H<sup>+</sup>/OH<sup>-</sup>) ---&gt; acid</div><div>4 - Rxn of Grignard reagent with dry ice</div><div>5 - Hydrolysis of acid chlorides/anhydrides</div><div>6 - Acidic hydrolysis of esters</div><br> 
Preparation of Compounds:<br> Carboxylic acid from primary alcohols/aldehydes	RCH<sub>2</sub>OH (w/ alkaline KMnO<sub>4</sub>&nbsp;+ H<sub>2</sub>O) ---&gt; RCOOH<div>RCH<sub>2</sub>OH (w/ CrO<sub>3</sub>/H<sup>+</sup>)&nbsp;---&gt; RCOOH</div><br> 
Preparation of Compounds:<br> Carboxylic acid from alkylbenzenes	Ar-CH<sub>3</sub>&nbsp;(w/ KMnO<sub>4</sub>-KOH + heat) ---&gt; Ar-COOK (w/ H<sub>3</sub>O<sup>+</sup>) ---&gt; Ar-COOH<div>Ar-R (w/ KMnO<sub>4</sub>-KOH + heat) ---&gt; Ar-COOK (w/ H<sub>3</sub>O<sup>+</sup>) ---&gt; Ar-COOH</div><br> 
Preparation of Compounds:<br> Carboxylic acid from nitriles and amides	R-CN (w/ H<sup>+</sup>/OH<sup>-&nbsp;</sup>+ H<sub>2</sub>O) ---&gt; R-CONH<sub>2</sub>&nbsp;(w/ H<sup>+</sup>/OH<sup>-</sup>) ---&gt; RCOOH<br> 
Preparation of Compounds:<br> Carboxylic acid from Grignard reagents	R-Mg-X + O=C=O (w/ dry ether) ---&gt; RCOO<sup>-</sup>MgX<sup>+</sup>&nbsp;(w/ H<sub>3</sub>O<sup>+</sup>) ---&gt; RCOOH<br> 
Preparation of Compounds:<br> Carboxylic acid from acyl halides	RCOCl (w/ H<sub>2</sub>O) ---&gt; RCOOH + Cl<sup>-</sup><div>RCOCl (w/ OH<sup>-</sup>&nbsp;and H<sub>2</sub>O) ---&gt; RCOO<sup>-</sup>&nbsp;+ Cl<sup>-</sup>&nbsp;(w/ H<sub>3</sub>O<sup>+</sup>) ---&gt; RCOOH</div><br> 
Preparation of Compounds:<br> Carboxylic acid from anhydride	(RCO)<sub>2</sub>O (w/ H<sub>2</sub>O) ---&gt; 2RCOOH<div>RCOOCOR' (w/ H<sub>2</sub>O) ---&gt; RCOOH + R'COOH</div><br> 
Describe the physical properties of aliphatic carboxylic acids.	Liquids: Upto 9 carbon atoms; unpleasant odours<div>Wax-like solids: More than 9 carbon atoms; odourless</div><div><br />Higher Bpt than aldehydes and ketones: because extensive H bonding</div><div>H bonding not broken in vapour phase</div><div>Exist as dimers in vapour phase</div>
Describe the miscibility of carboxylic acids.	Miscible in water: Upto 4 carbons; because H bonding<div>Higher carboxylic acids immiscible; because hydrophobic interaction of hydrocarbon part</div><div><br /></div><div>Benzoic acid nearly insolube in cold water</div><div>Carboxylic acids soluble in less polar organic solvents</div>
 Write the reaction for:<br> Acidic nature of carboxylic acids 	<br> 2R-COOH + 2Na ---&gt; 2R-COO<sup>-</sup>Na<sup>+</sup>&nbsp;+ H<sub>2</sub><div>R-COOH + NaOH ---&gt; R-COO<sup>-</sup>Na<sup>+</sup>&nbsp;+ H<sub>2</sub>O</div><div>R-COOH + NaHCO<sub>3</sub>&nbsp;---&gt; R-COO<sup>-</sup>Na<sup>+</sup>&nbsp;+ H<sub>2</sub>O + CO<sub>2</sub></div><br>   
Describe why, carboxylic acids are more acidic than phenols and alcohols.	1 - Resonance stablised conjugate base (carboxylate ion)<div>2 - Negative charge distributed over two atoms</div>
Describe the effect of substituents on the acidity of carboxylic acids.	1 - EWG stablises carboxylate ion; EWG--&lt;--COO<sup>-</sup>; increases acidity<div>2 - EDG destablises carboxylate ion; EDG--&gt;--COO<sup>-</sup>; decreases acidity</div>
Effect of groups on acidity of carboxylic acids:<div><span class=cloze>[...]</span> &lt; I &lt; Br &lt; Cl &lt; <span class=cloze>[...]</span> &lt; CN &lt;&nbsp;NO<sub>2</sub>&nbsp;&lt;&nbsp;CF<sub>3</sub></div>	Effect of groups on acidity of carboxylic acids:<div><span class=cloze>Ph</span> &lt; I &lt; Br &lt; Cl &lt; <span class=cloze>F</span> &lt; CN &lt;&nbsp;NO<sub>2</sub>&nbsp;&lt;&nbsp;CF<sub>3</sub></div><br> 
Effect of groups on acidity of carboxylic acids:<div>Ph &lt; I &lt; <span class=cloze>[...]</span> &lt; Cl &lt; F &lt; CN &lt;&nbsp;<span class=cloze>[...]</span>&nbsp;&lt;&nbsp;CF<sub>3</sub></div>	Effect of groups on acidity of carboxylic acids:<div>Ph &lt; I &lt; <span class=cloze>Br</span> &lt; Cl &lt; F &lt; CN &lt;&nbsp;<span class=cloze>NO<sub>2</sub></span>&nbsp;&lt;&nbsp;CF<sub>3</sub></div><br> 
Effect of groups on acidity of carboxylic acids:<div>Ph &lt; <span class=cloze>[...]</span> &lt; Br &lt; Cl &lt; F &lt; CN &lt;&nbsp;NO<sub>2</sub>&nbsp;&lt;&nbsp;<span class=cloze>[...]</span></div>	Effect of groups on acidity of carboxylic acids:<div>Ph &lt; <span class=cloze>I</span> &lt; Br &lt; Cl &lt; F &lt; CN &lt;&nbsp;NO<sub>2</sub>&nbsp;&lt;&nbsp;<span class=cloze>CF<sub>3</sub></span></div><br> 
Effect of groups on acidity of carboxylic acids:<div>Ph &lt; I &lt; Br &lt; <span class=cloze>[...]</span> &lt; F &lt; <span class=cloze>[...]</span> &lt;&nbsp;NO<sub>2</sub>&nbsp;&lt;&nbsp;CF<sub>3</sub></div>	Effect of groups on acidity of carboxylic acids:<div>Ph &lt; I &lt; Br &lt; <span class=cloze>Cl</span> &lt; F &lt; <span class=cloze>CN</span> &lt;&nbsp;NO<sub>2</sub>&nbsp;&lt;&nbsp;CF<sub>3</sub></div><br> 
Direct attachment of phenyl or vinyl groups to carboxylic acid, <span class=cloze>[...]</span>, contrary to the <span class=cloze>[...]</span> because of&nbsp;<span class=cloze>[...]</span>.	Direct attachment of phenyl or vinyl groups to carboxylic acid, <span class=cloze>increases the acidity</span>, contrary to the <span class=cloze>decrease expected due to resonance effect</span> because of&nbsp;<span class=cloze>greater electronegativity of sp<sup>2</sup>&nbsp;hybridised carbon atom</span>.<br> tl; dr: inductive effect &gt; resonance effect
<span class=cloze>[...]</span> is the strongest carboxylic acid.	<span class=cloze>Trifluoroacetic acid</span> is the strongest carboxylic acid.<br> 
 Write the reaction for:<br> Formation of anhydride 	<br> 2R-COOH (w/ H<sup>+</sup>&nbsp;or P<sub>2</sub>O<sub>5</sub>&nbsp;+ heat) ---&gt; (RCO)<sub>2</sub>O<br>   
 Write the reaction for:<br> Carboxylic acid with PCl<sub>3</sub>, PCl<sub>5</sub>, SOCl<sub>2</sub> 	<br> RCOOH + PCl<sub>5</sub> ---&gt; RCOCl<sub>3</sub>&nbsp;+ POCl<sub>3 </sub>+ HCl<div>3RCOOH + PCl<sub>3</sub>&nbsp;---&gt; 3RCOCl + H<sub>3</sub>PO<sub>3</sub></div><div>RCOOH + SOCl<sub>2</sub>&nbsp;---&gt; RCOCl + SO<sub>2</sub>&nbsp;+ HCl</div><br> SOCl<sub>2 </sub>preferred; because SO<sub>2</sub>, HCl are gases, escape easily.  
 Write the reaction for:<br> Carboxylic acid with ammonia 	<br> RCOOH + NH<sub>3</sub>&nbsp;---&gt; RCOO<sup>-</sup>NH<sub>4</sub><sup>+</sup>&nbsp;(w/ heat, -H<sub>2</sub>O) ---&gt; RCONH<sub>2</sub><div>Ar-COOH + NH<sub>3</sub>&nbsp;---&gt; Ar-COONH<sub>4</sub>&nbsp;(w/ heat, -H<sub>2</sub>O) ---&gt; Ar-CONH<sub>2</sub></div><div>orthobenzdioic acid + NH<sub>3</sub>&nbsp;---&gt; ammonium phthalate (w/ heat -2H<sub>2</sub>O) ---&gt; phthalamide (w/ strong heating, -NH<sub>3</sub>) ---&gt; phthalimide</div><br> pg 375  
 Write the reaction for:<br> Reduction of carboxylic acid 	<br> R-COOH (w/ (i) LiAlH<sub>4</sub>/ether or B<sub>2</sub>H<sub>6</sub>&nbsp;and (ii) H<sub>2</sub>O) ---&gt; RCH<sub>2</sub>OH<br>   
 Write the reaction for:<br> Decarboxylation (Kolbe's electrolysis) 	<br> R-COONa (w/ sodalime and heat) ---&gt; R-H + Na<sub>2</sub>CO<sub>3</sub><br>   
 Name the reaction(s): <br> R-COONa (w/ sodalime and heat) ---&gt; R-H + Na<sub>2</sub>CO<sub>3</sub>	Decarboxylation (Kolbe's electrolysis)  
 Write the reaction for:<br> Hell-Volhard-Zelinsky reaction 	<br> R-CH<sub>2</sub>-COOH (w/ (i) X<sub>2</sub>/red P and (ii) H<sub>2</sub>O) ---&gt;RCHX-COOH<br> X=Cl, Br  
 Name the reaction(s): <br> R-CH<sub>2</sub>-COOH (w/ (i) X<sub>2</sub>/red P and (ii) H<sub>2</sub>O) ---&gt;RCHX-COOH	Hell-Volhard-Zelinsky reaction  
 Write the reaction for:<br> Ring substitution of carboxylic acids 	<br> 1 - Ar-COOH (w/ conc HNO<sub>3</sub>&nbsp;+ H<sub>2</sub>SO<sub>4</sub>) ---&gt; m-nitrobenzoic acid<div>2 - Ar-COOH (w/ Br<sub>2</sub>/FeBr<sub>3</sub>) ---&gt; m-bromobenzoic acid</div><br>   
List the uses of formaldehyde.	<div>1 - preparation of bakelite</div>2 - formalin (40%): preservation of biological samples<div>3 - urea-formaldehyde: glues, polymeric pdts</div>
List the uses of acetaldehyde.	Starting material for acetic acid, ethyl acetate, vinyl acetate, polymers, drugs.
List the uses of benzaldehyde	Perfumery, dye industry.
<span class=cloze>[Ketone]</span> and <span class=cloze>[ketone]</span> are used as industrial solvents.	<span class=cloze>Acetone</span> and <span class=cloze>ethyl methyl ketone</span> are used as industrial solvents.<br> 
Acetone and ethyl methyl ketone are used as <span class=cloze>[...]</span>.	Acetone and ethyl methyl ketone are used as <span class=cloze>industrial solvents</span>.<br> 
<span class=cloze>[4 compounds]</span> are well known for their odours and flavours.	<span class=cloze>Butyraldehyde, vanillin, acetopheone, camphor</span> are well known for their odours and flavours.<br> 
List the uses of methanoic acid.	Rubber,<div>Textile,</div><div>Dying,</div><div>Leather,</div><div>Electroplating industries.</div>
List the uses of ethanoic acid.	Solvent, vinegar in food industry
Hexanedioic acid is used in <span class=cloze>[...]</span>.	Hexanedioic acid is used in <span class=cloze>the manufacture of nylon-6,6</span>.<br> 
<span class=cloze>[...]</span> is used in the manufacture of nylon-6,6.	<span class=cloze>Hexanedioic acid</span> is used in the manufacture of nylon-6,6.<br> 
Esters of benzoic acid are used in <span class=cloze>[...]</span>.	Esters of benzoic acid are used in <span class=cloze>perfumery</span>.<br> 
<span class=cloze>[...]</span> are used in perfumery.	<span class=cloze>Esters of benzoic acid</span> are used in perfumery.<br> 
Sodium benzoate is used as a <span class=cloze>[...]</span>.	Sodium benzoate is used as a <span class=cloze>food preservative</span>.<br> 
<span class=cloze>[...]</span> is used as a food preservative.	<span class=cloze>Sodium benzoate</span> is used as a food preservative.<br> 
Higher fatty acids are used in <span class=cloze>[...]</span>	Higher fatty acids are used in <span class=cloze>the manufacture of soaps and detergents.</span><br> 
<span class=cloze>[...]</span> are used in the manufacture of soaps and detergents.	<span class=cloze>Higher fatty acids</span> are used in the manufacture of soaps and detergents.<br> 
Preparation of Compounds:<br> Amines	1 - Reduction of nitro cmpds<div>2 - Aminolysis of alkyl halides</div><div>3 - Reduction of nitriles</div><div>4 - Reduction of amides</div><div>5 - Gabriel phthalamide synthesis</div><div>6 - Hoffman bromamide degradation reaction</div><br> 
 Write the reaction for:<br> Preparation of amine from reduction of nitro compounds. 	<br> Ar-NO<sub>2</sub>&nbsp;(w/ H<sub>2</sub>/Pd and ethanol) ---&gt; Ar-NH<sub>2</sub><div>Ar-NO<sub>2</sub>&nbsp;(w/ Sn+HCl or Fe+HCl) ---&gt; Ar-NH<sub>2</sub></div><br>   
 Write the reaction for:<br> Preparation of amine from aminolysis of alkyl halides. 	<br> :NH<sub>3&nbsp;</sub>+ R-X ---&gt; R-N<sup>+</sup>H<sub>3</sub>X<sup>-</sup><div>RNH<sub>2</sub>&nbsp;(w/ RX) ---&gt; R<sub>2</sub>NH (w/ RX) ---&gt; R<sub>3</sub>N (w/ RX) ---&gt; R<sub>4</sub>N<sup>+</sup>X<sup>-</sup></div><div><br /></div><div>R-NH<sub>3</sub>X + NaOH ---&gt; R-NH<sub>2</sub>&nbsp;+ H<sub>2</sub>O + NaX</div><br>   
 Write the reaction for:<br> Preparation of amine from reduction of nitriles. 	<br> R-CN (w/ H<sub>2</sub>/Ni or LiAlH<sub>4 </sub>or Na(Hg)/C<sub>2</sub>H<sub>5</sub>OH) ---&gt; R-CH<sub>2</sub>-NH<sub>2</sub><br> used for ascent of amine series;  
 Write the reaction for:<br> Preparation of amine from reduction of amides 	<br> RCONH<sub>2</sub>&nbsp;(w/ LiAlH<sub>4</sub>) ---&gt; R-CH<sub>2</sub>-NH<sub>2</sub><br>   
 Write the reaction for:<br> Gabriel phthalimide synthesis 	"<br> <img src=""2(36).png"" /><br>   "
" Name the reaction(s): <br> <img src=""2(36).png"" />"	Gabriel phthalimide synthesis  
 Write the reaction for:<br> Hoffman bromamide degradation 	<br> R-CO-NH<sub>2</sub>&nbsp;+ Br<sub>2</sub>&nbsp;+ 4NaOH ---&gt; R-NH<sub>2</sub>&nbsp;+ Na<sub>2</sub>CO<sub>3</sub>&nbsp;+ 2NaBr + 2H<sub>2</sub>O<br>   
 Mechanism for:<br> Esterification of alcohols 	<br> <div>Nucleophilic acyl substution:</div>1 - Protonation of carbonyl oxygen on acid<div>2 - Nucleophilic attack of alcohol on positive carbon to form tetrahedral intermediate</div><div>3 - Elimination of water to give protonated ester</div><div>4 - Deprotonation</div><br> w/ H<sup>+</sup>&nbsp;from conc. sulphuric acid 
 Write the reaction for:<br> Basic nature of amines 	<br> R-NH<sub>2</sub>&nbsp;+ HX ---&gt; R-N<sup>+</sup>H<sub>3</sub>X<sup>-</sup><sub>&nbsp;</sub>d<div>R-NH<sub>2</sub>&nbsp;+ H<sub>2</sub>O ---&gt; R-N<sup>+</sup>H<sub>3</sub>&nbsp;+ OH<sup>-</sup>&nbsp;</div><br>   
 Write the reaction for:<br> Treatment of amine salts with a base. 	<br> R-N<sup>+</sup>H<sub>3</sub>X<sup>-</sup>&nbsp;+ O<sup>-</sup>H ---&gt; R-NH<sub>2</sub>&nbsp;+ H<sub>2</sub>O + X<sup>-</sup><br>   
 Write the reaction for:<br> Alkylation of amines 	<br> <div>NH<sub>3</sub>&nbsp;+ R-X ---&gt; R-NH<sub>2</sub>&nbsp;+ HX</div>R-NH<sub>2</sub>&nbsp;+ R'-X ---&gt; RR'NH + HX<div>RR'NH + R''-X ---&gt; RR'R''N + HX</div><br>   
 Mechanism for:<br> Alkylation of amines 	<br> Nucleophilic Substitution<br>  
 Write the reaction for:<br> Acylation of amines 	<br> R-NH<sub>2</sub>&nbsp;+ R'COCl (w/ base) ---&gt; R'CONHR + HCl<div>R<sub>2</sub>NH + R'COCl (w/ base) ---&gt; R'CONR<sub>2 </sub>+ HCl</div><div>R-NH<sub>2</sub>&nbsp;+ (R'CO)<sub>2</sub>O ---&gt;R'CONHR + R'COOH&nbsp;</div><br>   
 Write the reaction for:<br> Carbylamine reaction 	primary amine + chloroform + alcoholic KOH ---&gt; carbylamine + KCl + water<br> R-NH<sub>2</sub>&nbsp;+ CHCl<sub>3</sub>&nbsp;+ 3KOH (w/ heat) ---&gt; R-NC + 3KCl + 3H<sub>2</sub>O<br> works only for primary amines  
 Write the reaction for:<br> Amines with nitrous acid 	<br> a - R-NH<sub>2</sub>&nbsp;(w/ NaNO<sub>2</sub>&nbsp;+ HCl) ---&gt; [R-N<sub>2</sub>Cl] (w/ H<sub>2</sub>O) ---&gt; R-OH + N<sub>2</sub>&nbsp;+ HCl<div>b - Ar-NH<sub>2</sub>&nbsp;(w/ NaNO<sub>2</sub>&nbsp;+ HCl) ---&gt; Ar-N<sub>2</sub>Cl + NaCl + 2H<sub>2</sub>O</div><br>   
<span class=cloze>[...]</span>&nbsp;is also known as Hinsberg's reagent.	<span class=cloze>Benzenesulphonyl chloride (C<sub>6</sub>H<sub>5</sub>SO<sub>2</sub>Cl)</span>&nbsp;is also known as Hinsberg's reagent.<br> 
Benzenesulphonyl chloride (C<sub>6</sub>H<sub>5</sub>SO<sub>2</sub>Cl)&nbsp;is also known as <span class=cloze>[...]</span>.	Benzenesulphonyl chloride (C<sub>6</sub>H<sub>5</sub>SO<sub>2</sub>Cl)&nbsp;is also known as <span class=cloze>Hinsberg's reagent</span>.<br> 
 Write the reaction for:<br> Amine with arylsulphonyl chloride 	<br> Ar-SO<sub>2</sub>Cl + H<sub>2</sub>N-R ---&gt; Ar-SO<sub>2</sub>-NHR<div>Ar-SO<sub>2</sub>Cl + HNR<sub>2</sub>&nbsp;---&gt; Ar-SO<sub>2</sub>-NR<sub>2</sub></div><div>Tertiary amines do not react with Hinsberg reagent</div><br>   
 Write the reaction for:<br> Bromination of aniline 	<br> Ar-NH<sub>2</sub>&nbsp;+ 3Br<sub>2</sub>&nbsp;(w/ bromine water) ---&gt; 2, 4, 6-tribromoaniline + 3HBr<br>   
Preparing monosubstituted aniline derivative is hard because <span class=cloze>[...]</span>.	Preparing monosubstituted aniline derivative is hard because <span class=cloze>aniline is very reactive towards nucleophilic substitution</span>.<br> 
 Write the reaction for:<br> Preparation of monosubstituted aniline derivative 	<br> Ar-NH<sub>2</sub>&nbsp;(w/ (CH<sub>3</sub>CO)<sub>2</sub>O and base) ---&gt; CH<sub>3</sub>CONH-Ar (w/ nucleophile) ---&gt; stuff (hydrolysis) ---&gt; para substituted aniline derivative<br> :N-C=O is a conjugate system; lp e<sup>-</sup>&nbsp;interact with oxygen; less available to benzene ring;  
 Write the reaction for:<br> Nitration of aniline 	<br> Ar-NH<sub>2</sub>&nbsp;(w/ HNO<sub>3</sub>&nbsp;and H<sub>2</sub>SO<sub>4</sub>) ---&gt; para(51%) + meta(47%) + ortho derivatives(2%)<div>Ar-NH<sub>2</sub>&nbsp;(w/ (CH<sub>3</sub>CO)<sub>2</sub>O and base) ---&gt; acetanilide (HNO<sub>3</sub>&nbsp;+ H<sub>2</sub>SO<sub>4</sub>) ---&gt; stuff (hydrolysis) ---&gt; p-nitroaniline</div><br>   
 Write the reaction for:<br> Sulphonation of aniline 	<br> Ar-NH<sub>2</sub>&nbsp;(w/ H<sub>2</sub>SO<sub>4</sub>) ---&gt; Ar-N<sup>+</sup>H<sub>3</sub>HSO<sub>4</sub><sup>-</sup>&nbsp;(at 453-473K) ---&gt; sulphanilic acid &lt;---&gt; zwitter ion<br>   
 Write the reaction for:<br> Friedel-Crafts reaction for aniline 	<br> does not occur<br>   
Preparation of Compounds:<br> Diazonium salts	Diazotisation of aromatic amines:<div>aryl amine (w/ HNO<sub>2</sub>) ---&gt; diazonium salt</div><br> 
 Write the reaction for:<br> Diazotisation 	<br> Ar-NH<sub>2</sub>&nbsp;+ NaNO<sub>2</sub>&nbsp;+ 2HCl (at 273-278K) ---&gt; Ar-N<sub>2</sub>Cl + NaCl + 2H<sub>2</sub>O<br>   
 Write the reaction for:<br> Sandmeyer reaction 	<br> <div>Ar-N<sub>2</sub>X (w/ Cu<sub>2</sub>Cl<sub>2</sub>/HCl&nbsp;) ---&gt; Ar-Cl + N<sub>2</sub></div>Ar-N<sub>2</sub>X (w/ Cu<sub>2</sub>Br<sub>2</sub>/HBr ) ---&gt; Ar-Br + N<sub>2</sub><br /><div>Ar-N<sub>2</sub>X (w/ CuCN/KCN ) ---&gt; Ar-CN + N<sub>2</sub></div><br>   
 Write the reaction for:<br> Gatterman reaction 	<br> Ar-N<sub>2</sub>X (w/ Cu/HCl) ---&gt; ArCl + N<sub>2</sub>&nbsp;+ CuX<div>Ar-N<sub>2</sub>X (w/ Cu/HBr) ---&gt; ArBr + N<sub>2</sub>&nbsp;+ CuX</div><br>   
 Write the reaction for:<br> Diazonium salt with potassium iodide 	<br> Ar-N<sub>2</sub>Cl + KI ---&gt; Ar-I + KCl + N<sub>2</sub><br>   
 Write the reaction for:<br> Replacement of diazonium group by fluoride ion 	<br> Ar-N<sub>2</sub>Cl + HBF<sub>4</sub>&nbsp;---&gt; ArN<sub>2</sub>BF<sub>4</sub>&nbsp;(w/ heat) ---&gt; Ar-F + BF<sub>3</sub>&nbsp;+ N<sub>2</sub><br>   
 Name the reaction(s): <br> <div>Ar-N<sub>2</sub>X (w/ Cu<sub>2</sub>Cl<sub>2</sub>/HCl&nbsp;) ---&gt; Ar-Cl + N<sub>2</sub></div>Ar-N<sub>2</sub>X (w/ Cu<sub>2</sub>Br<sub>2</sub>/HBr ) ---&gt; Ar-Br + N<sub>2</sub><br /><div>Ar-N<sub>2</sub>X (w/ CuCN/KCN ) ---&gt; Ar-CN + N<sub>2</sub></div>	Sandmeyer reaction  
 Name the reaction(s): <br> Ar-N<sub>2</sub>X (w/ Cu/HCl) ---&gt; ArCl + N<sub>2</sub>&nbsp;+ CuX<div>Ar-N<sub>2</sub>X (w/ Cu/HBr) ---&gt; ArBr + N<sub>2</sub>&nbsp;+ CuX</div>	Gatterman reaction  
 Write the reaction for:<br> Replacement of diazonium group by hydrogen 	"<br> Ar-N<sub>2</sub>Cl + H<sub>3</sub>PO<span style=""font-size: 17px""><sub>2</sub></span>&nbsp;+ H<sub>2</sub>O ---&gt; ArH + N<sub>2</sub>&nbsp;+ H<sub>3</sub>PO<sub>3</sub>&nbsp;+ HCl<div>Ar-N<sub>2</sub>Cl + R-CH<sub>2</sub>OH ---&gt; ArH + N<sub>2</sub>&nbsp;+ R-CHO + HCl</div><br>   "
 Write the reaction for:<br> Replacement of diazonium group by hydroxyl group 	<br> Ar-N<sub>2</sub>Cl + H<sub>2</sub>O ---&gt; Ar-OH + N<sub>2</sub>&nbsp;+ HCl<br>   
 Write the reaction for:<br> Replacement of diazonium group by nitro group 	<br> Ar-N<sub>2</sub>Cl + HBF<sub>4</sub>&nbsp;---&gt; Ar-N<sub>2</sub>BF<sub>4</sub>&nbsp;(w/ NaNO<sub>2</sub>, Cu and heat) ---&gt; Ar-NO<sub>2</sub>&nbsp;+ N<sub>2</sub>&nbsp;+ NaBF<sub>4</sub><br>   
 Write the reaction for:<br> Coupling reaction 	<br> Ar-N<sub>2</sub>Cl + Ar-OH (w/ OH<sup>-</sup>) ---&gt; Ar-N=N-Ar-OH + Cl<sup>-</sup>&nbsp;+ H<sub>2</sub>O<div>Ar-N<sub>2</sub>Cl + Ar-NH<sub>2</sub>&nbsp;(w/ H<sup>+</sup>) ---&gt; Ar-N=N-Ar-NH<sub>2</sub>&nbsp;+ Cl<sup>-</sup>&nbsp;+ H<sub>2</sub>O</div><br>   
"<span style=""font-family: 'Liberation Sans'"">Aromatic primary amines cannot be prepared by Gabriel Phthalimide Synthesis because&nbsp;</span><span class=cloze>[...]</span><span style=""font-family: 'Liberation Sans';"">.</span>"	"<span style=""font-family: 'Liberation Sans'"">Aromatic primary amines cannot be prepared by Gabriel Phthalimide Synthesis because&nbsp;</span><span class=cloze>aryl halides do not undergo nucleophilic substitution with phthalimide anion</span><span style=""font-family: 'Liberation Sans';"">.</span><br> "
"Grignard reagent yields:<br /><div><span class=cloze>[...]</span><span style=""font-family: 'Liberation Sans'"">&nbsp;with&nbsp;</span>formaldehyde<div style=""font-family: 'Liberation Sans';""><span class=cloze>[...]</span> with higher aldehydes</div><div style=""font-family: 'Liberation Sans';""><span class=cloze>[...]</span> with ketones</div></div>"	"Grignard reagent yields:<br /><div><span class=cloze>Primary alcohols</span><span style=""font-family: 'Liberation Sans'"">&nbsp;with&nbsp;</span>formaldehyde<div style=""font-family: 'Liberation Sans';""><span class=cloze>Secondary alcohol</span> with higher aldehydes</div><div style=""font-family: 'Liberation Sans';""><span class=cloze>Tertiary alcohols</span> with ketones</div></div><br> "
"Grignard reagent yields:<br /><div>Primary alcohols<span style=""font-family: 'Liberation Sans'"">&nbsp;with&nbsp;</span><span class=cloze>[...]</span><div style=""font-family: 'Liberation Sans';"">Secondary alcohol with <span class=cloze>[...]</span></div><div style=""font-family: 'Liberation Sans';"">Tertiary alcohols with <span class=cloze>[...]</span></div></div>"	"Grignard reagent yields:<br /><div>Primary alcohols<span style=""font-family: 'Liberation Sans'"">&nbsp;with&nbsp;</span><span class=cloze>formaldehyde</span><div style=""font-family: 'Liberation Sans';"">Secondary alcohol with <span class=cloze>higher aldehydes</span></div><div style=""font-family: 'Liberation Sans';"">Tertiary alcohols with <span class=cloze>ketones</span></div></div><br> "
"<span style=""font-family: 'Liberation Sans'"">Phenol bromination does not need a Lewis acid because&nbsp;</span><span class=cloze>[...]</span><span style=""font-family: 'Liberation Sans';"">.</span>"	"<span style=""font-family: 'Liberation Sans'"">Phenol bromination does not need a Lewis acid because&nbsp;</span><span class=cloze>-OH gp is activating</span><span style=""font-family: 'Liberation Sans';"">.</span><br> "
"Williamson synthesis w<span style=""font-family: 'Liberation Sans'"">orks better for&nbsp;</span><span class=cloze>[...]</span>."	"Williamson synthesis w<span style=""font-family: 'Liberation Sans'"">orks better for&nbsp;</span><span class=cloze>primary alkyl halides</span>.<br> "
"<span style=""font-family: 'Liberation Sans'"">Williamson synthesis gives&nbsp;</span><span class=cloze>[...]</span><span style=""font-family: 'Liberation Sans';"">&nbsp;with&nbsp;</span>tertiary alkyl halide<span style=""font-family: 'Liberation Sans';"">.</span>"	"<span style=""font-family: 'Liberation Sans'"">Williamson synthesis gives&nbsp;</span><span class=cloze>alkenes</span><span style=""font-family: 'Liberation Sans';"">&nbsp;with&nbsp;</span>tertiary alkyl halide<span style=""font-family: 'Liberation Sans';"">.</span><br> "
"<span style=""font-family: 'Liberation Sans'"">Williamson synthesis gives&nbsp;</span>alkenes<span style=""font-family: 'Liberation Sans';"">&nbsp;with&nbsp;</span><span class=cloze>[...]</span><span style=""font-family: 'Liberation Sans';"">.</span>"	"<span style=""font-family: 'Liberation Sans'"">Williamson synthesis gives&nbsp;</span>alkenes<span style=""font-family: 'Liberation Sans';"">&nbsp;with&nbsp;</span><span class=cloze>tertiary alkyl halide</span><span style=""font-family: 'Liberation Sans';"">.</span><br> "
"Halogenation of phenyl ethers does not require a Lewis acid because&nbsp;<span class=cloze>[...]</span><span style=""font-family: 'Liberation Sans'"">.</span>"	"Halogenation of phenyl ethers does not require a Lewis acid because&nbsp;<span class=cloze>-OR group on aryl ring is activating</span><span style=""font-family: 'Liberation Sans'"">.</span><br> "
List conditions for manufacture of ammonia by Haber's Process	1 - 200atm pressure<div>2 - 700K temperature</div><div>3 - Catalyst: K<sub>2</sub>O or Al<sub>2</sub>O<sub>3</sub></div>
"<span style=""font-family: 'Liberation Sans'"">Nitric acid obtained by Ostwald's process is concentrated to 98% by&nbsp;</span><span class=cloze>[...]</span><font face=""Liberation Sans"">.</font>"	"<span style=""font-family: 'Liberation Sans'"">Nitric acid obtained by Ostwald's process is concentrated to 98% by&nbsp;</span><span class=cloze><span style=""font-family: 'Liberation Sans';"">passing through conc H</span><sub style=""font-family: 'Liberation Sans';"">2</sub><span style=""font-family: 'Liberation Sans';"">SO</span><sub style=""font-family: 'Liberation Sans';"">4</sub></span><font face=""Liberation Sans"">.</font><br> "
A base is used in the acylation of amines because <span class=cloze>[...]</span>. The base used is stronger than the amine.	A base is used in the acylation of amines because <span class=cloze>it removes HCl and shifts equilibrium to the right</span>. The base used is stronger than the amine.<br> 
A base is used in the acylation of amines because it removes HCl and shifts equilibrium to the right. The base used is <span class=cloze>[...]</span>.	A base is used in the acylation of amines because it removes HCl and shifts equilibrium to the right. The base used is <span class=cloze>stronger than the amine</span>.<br> 
"<span class=cloze>[...]</span><span style=""font-family: 'Liberation Sans'"">&nbsp;is used to distinguish&nbsp;</span>primary, secondary and tertiary amines<span style=""font-family: 'Liberation Sans';"">.</span>"	"<span class=cloze>Hinsberg reagent</span><span style=""font-family: 'Liberation Sans'"">&nbsp;is used to distinguish&nbsp;</span>primary, secondary and tertiary amines<span style=""font-family: 'Liberation Sans';"">.</span><br> "
"Hinsberg reagent<span style=""font-family: 'Liberation Sans'"">&nbsp;is used to distinguish&nbsp;</span><span class=cloze>[...]</span><span style=""font-family: 'Liberation Sans';"">.</span>"	"Hinsberg reagent<span style=""font-family: 'Liberation Sans'"">&nbsp;is used to distinguish&nbsp;</span><span class=cloze>primary, secondary and tertiary amines</span><span style=""font-family: 'Liberation Sans';"">.</span><br> "
Nitration of aniline yields m-nitroaniline because&nbsp;<span class=cloze>[...]</span>.	Nitration of aniline yields m-nitroaniline because&nbsp;<span class=cloze>in strongly acidic medium aniline is protonated to anilinium ion which is meta directing</span>.<br> 
Reduction of ketones yields <span class=cloze>[...]</span>.	Reduction of ketones yields <span class=cloze>secondary alcohols</span>.<br> 
Reduction of <span class=cloze>[...]</span> yields secondary alcohols.	Reduction of <span class=cloze>ketones</span> yields secondary alcohols.<br> 
Hydroboration oxidation of alkenes to yield alcohols gives products according to <span class=cloze>[...]</span>.	Hydroboration oxidation of alkenes to yield alcohols gives products according to <span class=cloze>anti-Markovnikov rule</span>.<br> 
For addition of sodium hydrogensulphite to carbonyl compounds the equilibrium <span class=cloze>[...]</span> because of steric and electronic reasons.	For addition of sodium hydrogensulphite to carbonyl compounds the equilibrium <span class=cloze>is towards right for aldehydes and towards left for ketones</span> because of steric and electronic reasons.<br> 
"<span style=""font-family: 'Liberation Sans'"">Fehling soln A is&nbsp;</span><span class=cloze>[...]</span><div style=""font-family: 'Liberation Sans';"">Fehling soln B is <span class=cloze>[...]</span></div>"	"<span style=""font-family: 'Liberation Sans'"">Fehling soln A is&nbsp;</span><span class=cloze><span style=""font-family: 'Liberation Sans';"">CuSO</span><sub style=""font-family: 'Liberation Sans';"">4</sub><span style=""font-family: 'Liberation Sans';"">(aq)</span></span><div style=""font-family: 'Liberation Sans';"">Fehling soln B is <span class=cloze>sodium potassium tartarate (Rochelle salt)</span></div><br> "
In Fehling's test the ppt of&nbsp;Cu<sub>2</sub>O<sub>2</sub>&nbsp;is <span class=cloze>[colour]</span>.	In Fehling's test the ppt of&nbsp;Cu<sub>2</sub>O<sub>2</sub>&nbsp;is <span class=cloze>reddish brown</span>.<br> 
In Fehling's test the ppt of&nbsp;<span class=cloze>[...]</span>&nbsp;is reddish brown.	In Fehling's test the ppt of&nbsp;<span class=cloze>Cu<sub>2</sub>O<sub>2</sub></span>&nbsp;is reddish brown.<br> 
"<span class=cloze>[...]</span><span style=""font-family: 'Liberation Sans'"">&nbsp;used for detection of&nbsp;</span><span style=""font-family: 'Liberation Sans';"">CH</span><sub style=""font-family: 'Liberation Sans';"">3</sub><span style=""font-family: 'Liberation Sans';"">CO group</span><span style=""font-family: 'Liberation Sans';"">.</span>"	"<span class=cloze>Sodium hypoiodite</span><span style=""font-family: 'Liberation Sans'"">&nbsp;used for detection of&nbsp;</span><span style=""font-family: 'Liberation Sans';"">CH</span><sub style=""font-family: 'Liberation Sans';"">3</sub><span style=""font-family: 'Liberation Sans';"">CO group</span><span style=""font-family: 'Liberation Sans';"">.</span><br> "
"Sodium hypoiodite<span style=""font-family: 'Liberation Sans'"">&nbsp;used for detection of&nbsp;</span><span class=cloze>[...]</span><span style=""font-family: 'Liberation Sans';"">.</span>"	"Sodium hypoiodite<span style=""font-family: 'Liberation Sans'"">&nbsp;used for detection of&nbsp;</span><span class=cloze><span style=""font-family: 'Liberation Sans';"">CH</span><sub style=""font-family: 'Liberation Sans';"">3</sub><span style=""font-family: 'Liberation Sans';"">CO group</span></span><span style=""font-family: 'Liberation Sans';"">.</span><br> "
"For preparation of amines from nitro compounds&nbsp;<span class=cloze>[...]</span> is<span style=""font-family: 'Liberation Sans'"">&nbsp;preferred because&nbsp;</span><span class=cloze>[...]</span>"	"For preparation of amines from nitro compounds&nbsp;<span class=cloze>Fe+HCl</span> is<span style=""font-family: 'Liberation Sans'"">&nbsp;preferred because&nbsp;</span><span class=cloze><span style=""font-family: 'Liberation Sans';"">it produces FeCl</span><sub style=""font-family: 'Liberation Sans';"">3</sub><span style=""font-family: 'Liberation Sans';"">; FeCl</span><sub style=""font-family: 'Liberation Sans';"">3</sub><span style=""font-family: 'Liberation Sans';"">&nbsp;on hydrolysis gives HCl; ergo, little HCl is required.</span></span><br> "
What is the disadvantage of preparing amines from aminolysis of alkyl halides?	It yields a mixture of 1<sup>o</sup>, 2<sup>o</sup>, 3<sup>o</sup>, quaternary salt;<div>1<sup>o</sup>&nbsp;obtained as major pdt w/ excess NH<sub>3</sub>;</div>
<span class=cloze>[...]</span> is the commercial method of manufacture of benzaldehyde.	<span class=cloze>Side chain chlorination of methylbenzene</span> is the commercial method of manufacture of benzaldehyde.<br> 
 Write the reaction for:<br> Commercial conversion of carboxylic acid to alcohol. 	<br> RCOOH (w/ R'OH + H<sup>+</sup>)&nbsp;---&gt; RCOOR' (w/ H<sub>2&nbsp;</sub>+ catalyst)&nbsp;---&gt; RCH<sub>2</sub>OH + R'OH<br>   
"<span class=cloze>[carbonyl&nbsp;compound]</span><span style=""font-family: 'Liberation Sans'"">&nbsp;are easily oxidised by mild oxidising agents;<br /></span><div><span class=cloze>[carbonyl compound]</span><span style=""font-family: 'Liberation Sans';"">&nbsp;are oxidised under drastic conditions;</span></div>"	"<span class=cloze>Aldehydes</span><span style=""font-family: 'Liberation Sans'"">&nbsp;are easily oxidised by mild oxidising agents;<br /></span><div><span class=cloze>Ketones</span><span style=""font-family: 'Liberation Sans';"">&nbsp;are oxidised under drastic conditions;</span></div><br> "
"<span style=""font-family: 'Liberation Sans'"">Tollen's reagent is given by:</span><div><span class=cloze>[...]</span></div>"	"<span style=""font-family: 'Liberation Sans'"">Tollen's reagent is given by:</span><div><span class=cloze><span style=""font-family: 'Liberation Sans';"">[Ag(NH</span><sub style=""font-family: 'Liberation Sans';"">3</sub><span style=""font-family: 'Liberation Sans';"">)</span><sub style=""font-family: 'Liberation Sans';"">2</sub><span style=""font-family: 'Liberation Sans';"">]</span><sup style=""font-family: 'Liberation Sans';"">+</sup><span style=""font-family: 'Liberation Sans';"">&nbsp;+&nbsp;NO</span><sub style=""font-family: 'Liberation Sans';"">3</sub><sup style=""font-family: 'Liberation Sans';"">-</sup><span style=""font-family: 'Liberation Sans';"">&nbsp;+ 2OH</span><sup style=""font-family: 'Liberation Sans';"">-&nbsp;</sup><span style=""font-family: 'Liberation Sans';"">&lt;--- AgNO</span><sub style=""font-family: 'Liberation Sans';"">3</sub><span style=""font-family: 'Liberation Sans';"">&nbsp;+ 2NH</span><sub style=""font-family: 'Liberation Sans';"">4</sub><span style=""font-family: 'Liberation Sans';"">OH</span></span></div><br> "
